1111111111
1P0010C0E1
1110101111
1000000001
10C1101C01
10100X0101
1000110001
1111111111