1111111111111111111111
1000000100000000000001
1000101000000000000001
1000000000000000100001
1000000000000000001001
10CCC00000010000010101
1010000100000000000001
101PE00100010000000001
1011000100010000000001
1011111100010000101001
1111111111111111111111