1111111111111111111111
1000000100000000000001
1000101000000000000001
10000000C0000000100001
10000P0000000000001001
1000000000010000010101
1000000000000000000001
1000E00000010000000001
1000000000010000000001
1000000000010000101001
1111111111111111111111