1111111111111111111111
1000000100000000000001
1000101000000000000001
100000P000000000100001
1000000000000000001001
100000000001000001C101
1000000000000000000001
1000E00000010000000001
1000000000010000000001
10000000000100001C1001
1111111111111111111111