1111111
1000001
1PCE001
1000X01
1111111